1111111111111111111111111111111111111111111111111111111111111
1000000101000000000000000111000000101000000000101100011000011
1011100101011111111111110001111010100011111010100001001001001
1010100101000000100010001101000001111110001110111101011101111
1010110001101100000011101101011100100000100010100001000000001
1010010111100011111100001000001000001100101000111101111111101
1010000000000001000000000011111111111111111111110001000000101
1111111111000001000000000000000000000001010001100100011110111
1000000000010001000011001111111111110010010000001011000100001
1111011010100001000010000010000010010000000000111011110100111
1000100011111111110111000000101111001111111111100000000010001
1000000010000100001000000010000000000000000000111111110011101
1111111010000101001000111111101101111110111110100010001010001
1001001010000000000000000000000100000010100000001000100010101
1011100000111111111111000010101111111110111111110010111110111
1000000100000000000000000010100100000000000000000100000000001
1011110011111111111111111011111111111111111111011111111111101
1010001000000000000100000000000100000000010000010000001000001
1010101111111111110111101111101101111111000010110111101111101
1000100000000000000000000001000100000000011110000000101000001
1101111111101111111110111111111111101111111111111111101111111
1001000000000000000000001000000000000000000000000000000000001
1001011110000000000000001000000000000000000000000000000000001
1001011110000000000000000000000000000000000000000000000000001
1001000000000000000000000000000000000000000000000000000000001
1000000000000000000000000000200000000000000000000000000000001
1001000000000000000000000000000000000000000000000000000000001
1001000000000000000000000000000000000000000000000000000000001
1001000000000000000000000000000000000000000000000000000000001
1111111111111111111111111111111111111111111111111111111111111