2222222222222222222222222222222222222222222222222222222222222
2222222222222222222222111111111111111112222222222222222222222
2222222222222222222100000000000000000001112222222222222222222
2222222222222221111000000000000000000000001111222222222222222
2222222222221110000000000000000000000000000000011222222222222
2222222222110000000000000000000000000000000000000122222222222
2222222211000000000000000000000000000000000000000012222222222
2222222100000000000000000000000000000000000000000001222222222
2222221000000000000000000000000000000000000000000000222222222
2222221000000000000000000000000000000000000000000000112222222
2222210000000000000000000000000000000000000000000000001222222
2222100000000000000000000000000000000000000000000000000222222
2222100000000000000000000000000000000000000000000000000002222
2221000000000000000000000000000000000000000000000000000022222
2210000000000000000000000000000000000000000000000000000000122
2210000000000000000000000000000000000000000000000000000000122
2210000000000000000000000000000000000000000000000000000000122
2221000000000000000000000000000000000000000000000000000001222
2221000000000000000000000000000000000000000000000000000012222
2222100000000000000000000000000000000000000000000000000012222
2222210000000000000000000000000000000000000000000000000122222
2222211000000000000000000000000000000000000000000000001222222
2222222100000000000000000000000000000000000000000000012222222
2222222100000000000000000000000000000000000000000001122222222
2222222211000000000000000000000000000000000000000112222222222
2222222222110000000000000000000000000000000000001222222222222
2222222222221111100000000000000000000000000011112222222222222
2222222222222222211110000000000000000111111122222222222222222
2222222222222222222221111111111111111222222222222222222222222
2222222222222222222222222222222222222222222222222222222222222