2222222222222222222222222222222222222222222222222222222222
2222222222222222222211111111111111111122222222222222222222
2222222222222211111110000000000000000111111122222222222222
2222222222211110000000111111111111110000000111122222222222
2222222221110000111110000000000000000111110000111222222222
2222222111000111100000011110000111100000011110001112222222
2222221100011100000001110000000000111000000011100011222222
2222211001110000110011000001111000001100110000111001122222
2222110011000001110010011101221011100100111000001100112222
2221100000000011100010011101221011100100011100000000011222
2221001100001111000011000001111000001100001111000011001222
2221011000011110000001110000110000111000000111100001101222
2221000000011100000000011110110111100000000011100000001222
2211011000011101111110000000000000000111111011100001101122
2210011000000000000011111111001111111100000000000001100122
2210011000000000000011111111001111111100000000000001100122
2211011000011101111110000000000000000111111011100001101122
2221000000011100000000011110110111100000000011100000001222
2221011000011110000001110000110000111000000111100001101222
2221001100001111000011000001111000001100001111000011001222
2221100000000011100010011101221011100100011100000000011222
2222110011000001110010011101221011100100111000001100112222
2222211001110000110011000001111000001100110000111001122222
2222221100011100000001110000000000111000000011100011222222
2222222111000111100000011110000111100000011110001112222222
2222222221110000111110000000000000000111110000111222222222
2222222222211110000000111111111111110000000111122222222222
2222222222222211111110000000000000000111111122222222222222
2222222222222222222211111111111111111122222222222222222222
2222222222222222222222222222222222222222222222222222222222